AGV,Conflicts,Conflict_Wait,Conflict_Path,Waiting_Gate,Articles,Moving_Steps,Time_Steps
0,87,86,1,0,0,62,0
1,91,91,0,0,0,57,0
2,78,77,1,0,0,71,0
3,87,86,1,0,0,62,0
4,0,0,0,92,0,55,0
5,7,0,7,0,2,143,0
6,4,0,4,0,2,142,0
7,93,93,0,0,0,55,0
8,0,0,0,0,2,143,0
9,3,0,3,0,3,140,0
Total,450,433,17,92,9,930,0
