AGV,Conflicts,Conflict_Wait,Conflict_Path,Waiting_Gate,Articles,Moving_Steps,Time_Steps
0,2911,2843,68,2124,51,4064,0
1,62,17,45,5514,60,3479,0
2,3006,18,2988,2609,58,6390,0
3,2934,2890,44,1872,51,4269,0
4,2955,2912,43,3861,30,2297,0
5,3055,2927,128,2175,76,3869,0
6,93,30,63,4943,58,4036,0
7,1737,34,1703,2416,56,6565,0
8,2974,2919,55,3197,45,2916,0
9,2958,2909,49,3241,33,2923,0
10,60,7,53,3924,65,5073,0
11,1740,15,1725,270,98,8658,0
Total,24485,17521,6964,36146,681,54539,0
