AGV,Conflicts,Conflict_Wait,Conflict_Path,Waiting_Gate,Articles,Moving_Steps,Time_Steps
0,1150,1126,24,1984,16,1038,0
1,1115,1078,37,334,38,2696,0
2,1141,1115,26,108,46,2869,0
3,26,13,13,3102,12,1041,0
4,1123,1115,8,2489,8,564,0
5,1133,1082,51,1454,27,1589,0
6,1151,1105,46,1337,17,1703,0
7,1139,1120,19,1397,23,1619,0
8,1137,12,1125,2334,14,1807,0
Total,9115,7766,1349,14539,201,14926,0
