AGV,Conflicts,Conflict_Wait,Conflict_Path,Waiting_Gate,Articles,Moving_Steps,Time_Steps
0,217,35,182,10827,108,8672,0
1,198,37,161,8651,185,10691,0
2,321,28,293,8269,190,11082,0
3,217,35,182,7899,132,11556,0
4,204,41,163,14228,66,5354,0
5,307,74,233,9849,193,9423,0
6,191,62,129,12027,107,7443,0
7,285,81,204,9278,155,10069,0
8,204,61,143,13676,91,5815,0
9,170,16,154,6220,139,13259,0
10,300,18,282,5066,185,14303,0
11,319,34,285,3934,256,15285,0
Total,2933,522,2411,109924,1807,122952,0
