AGV,Conflicts,Conflict_Wait,Conflict_Path,Waiting_Gate,Articles,Moving_Steps,Time_Steps
0,258,84,174,17685,170,10853,29007
1,274,14,260,709,401,28266,0
2,394,21,373,8220,328,20600,29533
3,239,30,209,9898,218,19252,29641
4,101,14,87,18711,149,9741,28788
5,439,42,397,11978,287,16446,29090
6,197,31,166,14677,139,13909,28939
7,160,44,116,22724,98,6036,29045
8,331,72,259,20218,168,8121,28805
Total,2393,352,2041,124820,1958,133224,232848
