AGV,Conflicts,Conflict_Wait,Conflict_Path,Waiting_Gate,Articles,Moving_Steps,Time_Steps
0,284,44,240,50,108,7139,0
1,278,33,245,16,105,7185,0
2,376,52,324,72,104,7117,0
3,301,54,247,100,116,7063,0
4,301,57,244,13,105,7168,0
5,320,58,262,8,104,7175,0
6,414,59,355,120,109,7053,0
7,220,36,184,64,104,7140,0
8,288,44,244,0,109,7185,0
9,412,50,362,41,106,7145,0
10,207,33,174,61,110,7138,0
11,316,69,247,37,107,7131,0
Total,3717,589,3128,582,1287,85639,0
